R 1920 1080
NO ./textures/wall_1.xpm
SO ./textures/banner.xpm
WE ./textures/blue.xpm
EA ./textures/brick.xpm
S ./textures/sprite_3.xpm
F 184,113,39
C 51,198,227

        1111111111111111111111111
        1000000000110000000000001
        1011000001110022222000001
        1001000000000020000000001
111111111011000001110000000000001
100000000011000001110111110111111
11110111111111011100000010001
1111011111111101110101001000021
1100000011010101110000000000111
10002000000000000000000010001
100000000000000011010100100011111
11000001110101011111011110N00000111
11110111 1110101 1000000000011111
11111111 1111111 111111111111